1	0	0	6720	6720	
9	0	3360	3360	3360	
10	3360	3360	3360	3360	
11	0	0	3360	3360	
89	0	1680	1680	1680	
90	1680	1680	1680	1680	
91	0	0	1680	1680	
729	0	840	840	840	0	
730	840	840	840	840	
731	0	0	840	840	3	8	47	48	49	52	53	54	55	56	57	106	
732	840	0	840	840	1	3	8	9	10	50	51	58	59	60	61	62	63	64	104	105	600	601	602	603	
92	1680	0	1680	1680	
737	1680	840	840	840	
738	2520	840	840	840	
739	1680	0	840	840	3	10	11	65	66	67	68	69	70	107	604	605	200	
740	2520	0	840	840	2	3	4	12	13	14	35	36	46	71	72	73	74	75	76	77	84	85	107	108	606	612	109	112	620	621	
12	3360	0	3360	3360	
97	3360	1680	1680	1680	
98	5040	1680	1680	1680	
99	3360	0	1680	1680	
793	3360	840	840	840	
794	4200	840	840	840	
795	3360	0	840	840	5	6	12	14	15	16	17	18	19	20	21	22	23	24	25	26	27	28	29	30	31	32	33	34	35	36	37	38	39	40	41	42	78	79	80	81	82	83	86	87	88	89	90	91	607	608	609	610	611	613	110	111	113	114	115	119	201	202	203	120	
796	4200	0	840	840	19	41	43	92	93	94	95	96	97	103	614	615	616	617	116	118	
100	5040	0	1680	1680	
801	5040	840	840	840	
802	5880	840	840	840	
803	5040	0	840	840	7	19	44	45	98	99	100	101	102	618	619	204	121	
804	5880	0	840	840	
END
500	501	502	1000	