1	0	0	3840	3840	
9	0	1920	1920	1920	
10	1920	1920	1920	1920	
11	0	0	1920	1920	
89	0	960	960	960	
713	0	1440	480	480	
714	480	1440	480	480	
715	0	960	480	480	59	61	62	113	117	222	
716	480	960	480	480	60	61	110	111	112	113	
90	960	960	960	960	
721	960	1440	480	480	
722	1440	1440	480	480	
723	960	960	480	480	60	106	107	108	109	221	
724	1440	960	480	480	56	57	58	60	105	116	159	
91	0	0	960	960	
729	0	480	480	480	51	52	53	55	102	103	104	156	157	205	
730	480	480	480	480	47	51	53	54	99	100	101	102	233	240	241	
731	0	0	480	480	20	26	27	81	82	83	154	216	
732	480	0	480	480	24	25	26	78	79	80	81	215	
92	960	0	960	960	
737	960	480	480	480	43	44	45	46	47	50	51	95	96	97	98	158	220	234	242	
738	1440	480	480	480	31	41	42	43	44	45	46	47	48	49	84	94	155	204	218	219	236	237	238	
739	960	0	480	480	24	74	75	76	77	214	
740	1440	0	480	480	16	17	18	19	22	23	24	71	72	73	213	217	230	
12	1920	0	1920	1920	
97	1920	960	960	960	
98	2880	960	960	960	
99	1920	0	960	960	
793	1920	480	480	480	32	33	34	40	41	85	86	92	93	231	232	39	
794	2400	480	480	480	35	37	38	39	87	90	91	92	203	231	40	
795	1920	0	480	480	12	13	14	15	21	28	29	30	67	68	69	70	202	212	
796	2400	0	480	480	0	1	2	3	8	9	10	11	28	63	66	67	115	150	152	153	
100	2880	0	960	960	
801	2880	480	480	480	35	36	88	89	118	
802	3360	480	480	480	
803	2880	0	480	480	4	5	6	7	8	9	64	65	114	151	200	201	210	211	
804	3360	0	480	480	
END
500	501	502	503	504	505	1000	506	507	508	509	511	512	